R      19209847442958749357892 8912478236587264578426785
NO       ./path_to_the_north_texture     
SO ./path_to_the_south_texture     
EA      ./path_to_the_east_texture     
WE                              ./path_to_the_west_texture      

F      220,   100      ,0    

S    ./path_to_the_sprite_texture       
C     125,        ,      255


    

    
        1111111111111111111111111
        1000000000110000000000001
        1011000001110000002000001
        1001000001010000000000001
111111111011000001110000000000001
100000000011000001110111111111111
11110111111111011100000010001
11110111111 11011101010010001
11000000110101011100000010001
1000200000000000110000001000111111111
10000000000000001101010010001
11000001110101011111011110N0111
11110111 1110101 101111010001
11111111 1111111 111211111111
111                          
101
11
    
    111
    //игрок вне карты
    //двойная карта
    //спрайн на стене
    //атой защита