
SO ./xpm/5.xpm
NO ./xpm/1.xpm
WE ./xpm/2.xpm
EA ./xpm/6.xpm
S ./xpm/alpaka2
R   1500 800



F 114,47,55

C 16,147,147






1111111111111
1000000000001   
1000000000001  
1000011000111   
1000000000001
1000000000001
1100011000011
1000000000001
10200W1111111
1111111111111

  