R 1500 1000
SO ./xpm/1.xpm
NO ./xpm/3.xpm
WE ./xpm/2.xpm
EA ./xpm/4.xpm
S ./xpm/barrel.xpm 
F 120,120,120
C 0,0,80

    
   

1111111111111111111111111
1000000000110020000000001
1011000001110020000000011
1001000000000020000000001
1111110110110000011100001111111111111111111111111111
100000000011000001110111111111111
11110111111111011100000010001
11110111111111011101010010001
11000000110101011100000010001
11111111111111111111111111111
11111111111111111111111111111
10000000000000000000000000001
10000000000000001101010010001
1100000111010101111101111000111
11110111 1110101 101111000W01
11111111 1111111 111111111111


  